111111111111111
1ECC000P1111111
1F0000C11110111
111111111111111