11111111
10000001
10E00PC1
11111111