1111111
1C0E0P1
1CC0001
1111111