11111111
1C01C101
10E01P01
11111111