111111111111111
1ECC000P1111111
100000C11110001
111111111111111