111111111
1E1C0P101
101100001
100101101
10C001CC1
111111111